currency_code	currency_name
AED	United Arab Emirates Dirham
AFN	Afghan Afghani
ALL	Albanian Lek
AMD	Armenian Dram
ANG	Netherlands Antillean Guilder
AOA	Angolan Kwanza
ARS	Argentine Peso
AUD	Australian Dollar
AWG	Aruban Florin
AZN	Azerbaijani Manat
BAM	Bosnia-Herzegovina Convertible Mark
BBD	Barbadian Dollar
BDT	Bangladeshi Taka
BGN	Bulgarian Lev
BHD	Bahraini Dinar
BIF	Burundian Franc
BMD	Bermudan Dollar
BND	Brunei Dollar
BOB	Bolivian Boliviano
BRL	Brazilian Real
BSD	Bahamian Dollar
BTN	Bhutanese Ngultrum
BWP	Botswanan Pula
BZD	Belize Dollar
CAD	Canadian Dollar
CDF	Congolese Franc
CHF	Swiss Franc
CLF	Chilean Unit of Account UF
CLP	Chilean Peso
CNH	Chinese Yuan Offshore
CNY	Chinese Yuan
COP	Colombian Peso
CUP	Cuban Peso
CVE	Cape Verdean Escudo
CZK	Czech Republic Koruna
DJF	Djiboutian Franc
DKK	Danish Krone
DOP	Dominican Peso
DZD	Algerian Dinar
EGP	Egyptian Pound
ERN	Eritrean Nakfa
ETB	Ethiopian Birr
EUR	Euro
FJD	Fijian Dollar
FKP	Falkland Islands Pound
GBP	British Pound Sterling
GEL	Georgian Lari
GHS	Ghanaian Cedi
GIP	Gibraltar Pound
GMD	Gambian Dalasi
GNF	Guinean Franc
GTQ	Guatemalan Quetzal
GYD	Guyanaese Dollar
HKD	Hong Kong Dollar
HNL	Honduran Lempira
HRK	Croatian Kuna
HTG	Haitian Gourde
HUF	Hungarian Forint
IDR	Indonesian Rupiah
ILS	Israeli New Sheqel
INR	Indian Rupee
IQD	Iraqi Dinar
IRR	Iranian Rial
JEP	Jersey Pound
JMD	Jamaican Dollar
JOD	Jordanian Dinar
JPY	Japanese Yen
KES	Kenyan Shilling
KGS	Kyrgystani Som
KHR	Cambodian Riel
KMF	Comorian Franc
KPW	North Korean Won
KRW	South Korean Won
KWD	Kuwaiti Dinar
KYD	Cayman Islands Dollar
KZT	Kazakhstani Tenge
LAK	Laotian Kip
LBP	Lebanese Pound
LKR	Sri Lankan Rupee
LRD	Liberian Dollar
LSL	Lesotho Loti
LYD	Libyan Dinar
MAD	Moroccan Dirham
MDL	Moldovan Leu
MGA	Malagasy Ariary
MKD	Macedonian Denar
MMK	Myanma Kyat
MNT	Mongolian Tugrik
MOP	Macanese Pataca
MRO	Mauritanian Ouguiya (pre-2018)
MRU	Mauritanian Ouguiya
MUR	Mauritian Rupee
MVR	Maldivian Rufiyaa
MWK	Malawian Kwacha
MXN	Mexican Peso
MYR	Malaysian Ringgit
MZN	Mozambican Metical
NAD	Namibian Dollar
NGN	Nigerian Naira
NOK	Norwegian Krone
NPR	Nepalese Rupee
NZD	New Zealand Dollar
OMR	Omani Rial
PAB	Panamanian Balboa
PEN	Peruvian Nuevo Sol
PGK	Papua New Guinean Kina
PHP	Philippine Peso
PKR	Pakistani Rupee
PLN	Polish Zloty
PYG	Paraguayan Guarani
QAR	Qatari Rial
RON	Romanian Leu
RSD	Serbian Dinar
RUB	Russian Ruble
RUR	Old Russian Ruble
RWF	Rwandan Franc
SAR	Saudi Riyal
SBDf	Solomon Islands Dollar
SCR	Seychellois Rupee
SDG	Sudanese Pound
SEK	Swedish Krona
SGD	Singapore Dollar
SHP	Saint Helena Pound
SLL	Sierra Leonean Leone
SOS	Somali Shilling
SRD	Surinamese Dollar
SYP	Syrian Pound
SZL	Swazi Lilangeni
THB	Thai Baht
TJS	Tajikistani Somoni
TMT	Turkmenistani Manat
TND	Tunisian Dinar
TOP	Tongan Pa'anga
TRY	Turkish Lira
TTD	Trinidad and Tobago Dollar
TWD	New Taiwan Dollar
TZS	Tanzanian Shilling
UAH	Ukrainian Hryvnia
UGX	Ugandan Shilling
USD	United States Dollar
UYU	Uruguayan Peso
UZS	Uzbekistan Som
VND	Vietnamese Dong
VUV	Vanuatu Vatu
WST	Samoan Tala
XAF	CFA Franc BEAC
XAG	Silver Ounce
XAU	Gold Ounce
XCD	East Caribbean Dollar
XDR	Special Drawing Rights
XOF	CFA Franc BCEAO
XPF	CFP Franc
YER	Yemeni Rial
ZAR	South African Rand
ZMW	Zambian Kwacha
ZWL	Zimbabwean Dollar
1ST	FirstBlood
2GIVE	GiveCoin
808	808Coin
AC	AsiaCoin
ACT	Achain
ADA	Cardano
ADT	adToken
ADX	AdEx
AE	Aeternity
AEON	Aeon
AGI	SingularityNET
AGRS	IDNI-Agoras
AI	POLY-AI
AION	Aion
AIR	AirToken
AKY	Akuya-Coin
ALIS	ALIS
AMBER	AmberCoin
AMP	Synereo
ANC	Anoncoin
ANT	Aragon
APPC	AppCoins
APX	APX-Ventures
ARDR	Ardor
ARK	Ark
AST	AirSwap
ATB	ATBCoin
ATM	ATMChain
ATS	Authorship
AUR	Auroracoin
AVT	Aventus
B3	B3Coin
BAT	Basic-Attention-Token
BAY	BitBay
BBR	Boolberry
BCAP	BCAP
BCC	BitConnect
BCD	Bitcoin-Diamond
BCH	Bitcoin-Cash
BCN	Bytecoin
BCX	BitcoinX
BCY	BitCrystals
BDL	Bitdeal
BELA	BelaCoin
BET	DAO-Casino
BIS	Bismuth
BITB	BitBean
BITBTC	BitBTC
BITCNY	BitCNY
BITEUR	BitEUR
BITGOLD	BitGOLD
BITSILVER	BitSILVER
BITUSD	BitUSD
BIX	Bibox-Token
BLITZ	Blitzcash
BLK	Blackcoin
BLN	Bolenum
BLOCK	Blocknet
BMC	Blackmoon-Crypto
BNB	Binance-Coin
BNT	Bancor-Network-Token
BNTY	Bounty0x
BOST	BoostCoin
BOT	Bodhi
BQ	bitqy
BRD	Bread
BTA	Bata
BTC	Bitcoin
BTCD	BitcoinDark
BTG	Bitcoin-Gold
BTM	Bitmark
BTS	BitShares
BTSR	BTSR
BTX	Bitcore
BURST	Burstcoin
BUZZ	BuzzCoin
BYC	Bytecent
BYTOM	Bytom
CANN	CannabisCoin
CAT	BlockCAT
CCRB	CryptoCarbon
CDT	Coindash
CFI	Cofound-it
CHIPS	Chips
CLAM	Clams
CLOAK	CloakCoin
CMP	Compcoin
CMT	CyberMiles
CND	Cindicator
CNX	Cryptonex
COFI	CoinFi
COSS	COSS
COVAL	Circuits-Of-Value
CRBIT	CreditBIT
CREA	CreativeCoin
CREDO	Credo
CRW	Crown
CSNO	BitDice
CTR	Centra
CURE	CureCoin
CVC	Civic
DAR	Darcrus
DASH	Dash
DATA	DATAcoin
DAY	Chronologic
DBC	DeepBrain-Chain
DCN	Dentacoin
DCR	Decred
DCT	DECENT
DDF	Digital-Developers-Fund
DENT	Dent
DFS	DFSCoin
DGB	DigiByte
DGC	Digitalcoin
DGD	DigixDAO
DICE	Etheroll
DLT	Agrello-Delta
DNT	district0x
DOGE	DogeCoin
DOPE	DopeCoin
DRGN	Dragonchain
DTB	Databits
DYN	Dynamic
EAC	EarthCoin
EBST	eBoost
EBTC	eBTC
ECC	ECC
ECN	E-coin
EDG	Edgeless
EDO	Eidoo
ELA	Elastos
ELF	aelf
ELIX	Elixir
EMB	Embercoin
EMC	Emercoin
EMC2	Einsteinium
ENG	Enigma
ENJ	Enjin-Coin
EOS	EOS
EOT	EOT-Token
EQT	EquiTrader
ETC	Ethereum-Classic
ETH	Ethereum
ETHD	Ethereum-Dark
ETHOS	Ethos
ETN	Electroneum
ETP	Metaverse-Entropy
ETT	EncryptoTel
EVE	Devery
EVX	Everex
EXP	Expanse
FCT	Factom
FLDC	FoldingCoin
FLO	FlorinCoin
FLT	FlutterCoin
FRST	FirstCoin
FTC	Feathercoin
FUEL	Etherparty
FUN	FunFair
GAM	Gambit
GAME	GameCredits
GAS	Gas
GBG	Golos Gold
GBYTE	Byteball
GCR	GCRCoin
GLD	GoldCoin
GNO	Gnosis-Token
GNT	Golem-Tokens
GOLOS	Golos
GRC	Gridcoin
GRWI	Growers-International
GTO	Gifto
GUP	Guppy
GVT	Genesis-Vision
GXS	GXShares
HBN	HoboNickels
HEAT	HEAT
HMQ	Humaniq
HPB	High-Performance-Blockchain
HSR	Hshare
HUSH	Hush
HVN	Hive
ICN	ICONOMI
ICX	ICON
IFC	Infinitecoin
IFT	investFeed
IGNIS	Ignis
INCNT	Incent
IND	Indorse-Token
INF	InfChain
INK	Ink
INS	INS-Ecosystem
INXT	Internxt
IOC	IOCoin
ION	ION
IOP	Internet-of-People
IOST	IOStoken
IOTA	IOTA
IQT	Iquant-Chain
ITC	IoT-Chain
IXC	iXcoin
IXT	InsureX
JNT	Jibrel-Network
KCS	KuCoin
KICK	KickCoin
KIN	KIN
KMD	Komodo
KNC	Kyber-Network
KORE	KoreCoin
LBC	LBRY-Credits
LCC	Litecoin-Cash
LEND	EthLend
LEV	Leverj
LGD	Legends-Room
LINDA	Linda
LINK	ChainLink
LKK	Lykke
LMC	LoMoCoin
LOCI	LOCIcoin
LRC	Loopring
LSK	Lisk
LTC	Litecoin
LUN	Lunyr
MAID	MaidSafeCoin
MANA	Decentraland
MAX	Maxcoin
MBRS	Embers
MCAP	MCAP
MCO	Monaco
MDA	Moeda-Loyalty-Points
MEC	Megacoin
MED	MediBlock
MEME	Memetic
MER	Mercury
MGC	MergeCoin
MGO	MobileGo
MINEX	Minex
MINT	Mintcoin
MKR	Maker
MLN	Melon
MNE	Minereum
MNX	MinexCoin
MONA	MonaCoin
MRT	Miners-Reward-Token
MSP	Mothership
MTH	Monetha
MTN	MedToken
MUE	MonetaryUnit
MUSIC	Musicoin
MYB	MyBit-Token
MYST	Mysterium
MZC	Mazacoin
NAMO	Namocoin
NAS	Nebulas-Token
NAV	Nav-Coin
NBT	NuBits
NDC	NeverDie-Coin
NEBL	Neblio
NEO	NEO
NEOS	NeosCoin
NET	Nimiq
NLC2	NoLimitCoin
NLG	Gulden
NMC	Namecoin
NMR	Numeraire
NOBL	NobleCoin
NOTE	DNotes
NSR	NuShares
NTO	Fujinto
NULS	Nuls
NVC	Novacoin
NXC	Nexium
NXS	Nexus
NXT	Nxt
OAX	openANX
OBITS	Obits
OCL	Oceanlab
OCN	Odyssey
ODN	Obsidian
OF	OFCOIN
OK	OKCash
OMG	OmiseGo
OMNI	Omni
ONION	DeepOnion
OPT	Opus
OST	Simple-Token
PART	Particl
PASC	PascalCoin
PAY	TenX
PBL	Pebbles
PBT	Primalbase-Token
PFR	Payfair
PING	CryptoPing
PINK	Pinkcoin
PIVX	PIVX
PIX	Lampix
PLBT	Polybius
PLR	Pillar
PLU	Pluton
POE	Poet
POLY	Polymath
POSW	PoSW-Coin
POT	PotCoin
POWR	Power-Ledger
PPC	Peercoin
PPT	Populous
PPY	Peerplays
PRG	Paragon-Coin
PRL	Oyster-Pearl
PRO	Propy
PST	Primas
PTC	Pesetacoin
PTOY	Patientory
PURA	Pura
QASH	QASH
QAU	Quantum
QRK	Quark
QRL	Quantum-Resistant-Ledger
QSP	Quantstamp
QTL	Quatloo
QTUM	Qtum
QWARK	Qwark
R	Revain
RADS	Radium
RAIN	Condensate
RBIES	Rubies
RBX	Ripto-Bux
RBY	RubyCoin
RCN	Ripio-Credit-Network
RDD	ReddCoin
RDN	Raiden-Network-Token
REC	Regalcoin
RED	Redcoin
REP	Augur
REQ	Request-Network
RHOC	RChain
RIC	Riecoin
RISE	Rise
RLC	RLC-Token
RLT	RouletteToken
RRT	Recovery-Right-Tokens
RUP	Rupee
RVT	Rivetz
SAFEX	SafeExchangeCoin
SALT	Salt
SAN	Santiment-Network-Token
SBD	Steem-Dollars
SBTC	Super-Bitcoin
SC	Siacoin
SEQ	Sequence
SHIFT	SHIFT
SIGMA	SIGMAcoin
SIGT	Signatum
SJCX	Storjcoin-X
SKIN	SkinCoin
SKY	Skycoin
SLS	SaluS
SMART	SmartCash
SMT	SmartMesh
SNC	SunContract
SNGLS	SingularDTV
SNM	SONM
SNRG	Synergy
SNT	Status-Network-Token
SPANK	SpankChain
SPR	SpreadCoin
SRN	Sirin-Labs-Token
START	Startcoin
STEEM	Steem
STK	STK-Token
STORJ	Storj
STRAT	Stratis
STX	Stox
SUB	Substratum
SWT	Swarm-City
SYS	SysCoin
TAAS	Taas
TAU	Lamden
TCC	The-ChampCoin
TFL	True-Flip
THC	HempCoin
TIME	Time
TIX	Blocktix
TKN	TokenCard
TKR	Trackr
TKS	Tokes
TNB	Time-New-Bank
TNT	Tierion
TOA	ToaCoin
TRC	Terracoin
TRCT	Tracto
TRIG	Triggers
TRST	Trustcoin
TRX	Tronix
UBQ	Ubiq
UKG	UnikoinGold
ULA	Ulatech
UNITY	SuperNET
UNO	Unobtanium
UNY	Unity-Ingot
URO	Uro
USDT	Tether
UTK	UTrust
VEE	BLOCKv
VEN	VeChain
VERI	Veritaseum
VIA	Viacoin
VIB	Viberate
VIVO	VIVO
VOISE	Voise
VOX	Voxels
VPN	VPNCoin
VRC	Vericoin
VRM	Verium
VRS	Veros
VSL	vSlice
VTC	Vertcoin
VTR	vTorrent
WABI	WaBi
WAVES	Waves
WAX	Wax-Token
WCT	Waves-Community
WDC	WorldCoin
WGO	WavesGo
WGR	Wagerr
WINGS	Wings
WTC	Walton
WTT	Giga-Watt-Token
XAS	Asch
XAUR	Xaurum
XBC	Bitcoin-Plus
XBY	XtraBYtes
XCN	Cryptonite
XCP	Counterparty
XDN	DigitalNote
XEL	Elastic
XEM	NEM
XID	Sphere-Identity
XLM	Stellar
XMR	Monero
XMT	Metal
XMY	Myriadcoin
XPM	Primecoin
XRB	RaiBlocks
XRL	Rialto
XRP	Ripple
XSPEC	Spectrecoin
XST	Stealthcoin
XTZ	Tezos
XUC	Exchange-Union
XVC	Vcash
XVG	Verge
XWC	WhiteCoin
XZC	ZCoin
XZR	ZrCoin
YOYOW	YOYOW
ZCC	ZcCoin
ZCL	Zclassic
ZEC	Zcash
ZEN	ZenCash
ZET	Zetacoin
ZRX	0x